111111111111
100000000001
10P000000001
1000000000001111111
111111111111
