111111111111
100000000001
100000000001
100000111111
100000100001
100P00000001
100000000001
111111111111
