1111111111111
1000001000001
1000001000001
1001000111111
1000001000101
100P010000001
1000001000001
1000100000001
1000100000001
1100000000001
1000100000001
1000100000001
1000100000001
1111111111111
