111111111111
100000000001
100000000001
100000000001
100100000001
111P00000001
100000000001
100000000001
100000000001
100000000001
100000000001
100000000001
100000000001
111111111111
